NO ./img/tex_wall_01.xpm
SO ./img/tex_wall_02.xpm
WE ./img/tex_wall_03.xpm
EA ./img/tex_wall_04.xpm

F 0,120,0
C 0,0,120


1111
1111
1111