IMG assets/img/common/index.json
IMG assets/img/afg/index.json

S_MUSIC assets/audio/olafur/m_afg.mp3
S_WIN assets/audio/olafur/e_win.mp3
S_LOSE assets/audio/olafur/e_lose.mp3
S_COLLEC assets/audio/olafur/e_collec.mp3

SK afg_sk

1NO afg_1_w
1SO afg_1_w2
1WE afg_1_w3
1EA afg_1_w3

2NO afg_2_w
2SO afg_2_w
2WE afg_2_w2
2EA afg_2_w2

3NO afg_3_w
3SO afg_3_w2
3WE afg_3_w3
3EA afg_3_w3

4NO afg_4_w2
4SO afg_4_w
4WE afg_4_w3
4EA afg_4_w4

G null

1F afg_f_in
2F afg_f
1C afg_c

D 7 2 afg_d afg_d_open SO
D 15 2 afg_d afg_d_open SO
D 25 2 afg_d afg_d_open SO
D 3 4 afg_d afg_d_open SO
D 11 4 afg_d afg_d_open SO
D 20 4 afg_d afg_d_open SO
D 8 13 afg_d afg_d_open EA
D 9 15 afg_d afg_d_open EA
D 6 17 afg_d afg_d_open WE
D 10 18 afg_d afg_d_open EA
D 18 19 afg_d afg_d_open WE
D 9 21 afg_d afg_d_open SO
D 8 23 afg_d afg_d_open NO
D 28 25 afg_d afg_d_open EA

PT WE 31 3 afg_p afg_p_open assets/maps/olafur/mus.map EA 0 4

SP 4.5 20.5 sprite_afg1 collision
SP 27.5 7.5 sprite_afg2 collision
SP 3.5 16.5 sprite_afg3 collision
SP 15.5 12.5 sprite_cage collision
SP 23.5 15.5 sprite_cage collision

SP 19.5 3.5 sprite_book1 collectible collision
SP 15.5 7.5 sprite_book2 collectible collision
SP 13.5 25.5 sprite_book3 collectible collision
SP 19.5 21.5 sprite_book4 collectible collision

11111122211111222111111122211111
10000020200000202000000020200001
10222020202220202002220020200001
102S2000002020000002020000000000
10202000002020000002020000000001
10000000000000000000000000000001
10000003333333333333000000000001
10000003000000000003000000000001
10000003000000000003000000000001
10000003300333333333000000000001
10000000000000000000033330333333
10000000000000000000030030030003
10000022200000040000000030030003
10000020000000000000033333333033
10000022220000000000000000000001
10000002000000000000000400000001
10000022220000000000000000000001
10000000222000000000000000000001
10000022200000000033333333333333
10000000222000000000000000000003
10000000202000000033333333333333
10000000202000000000000000000001
10000000000000000000000222222001
1000033303222220000000020G002001
10000300000020200000000200202001
10000300030000200000000222200001
11111333332222211111111111111111

22222211122222111222222211122222
22222211122222111222222211122222
22111211121112111221112211122222
22111222221112222221112222222222
22111222221112222221112222222222
22222222222222222222222222222222
22222221111111111111222222222222
22222221121111111211222222222222
22222221111111111111222222222222
22222221111111111111222222222222
22222222222222222222211111111111
22222222222222222222211111111111
22222211122222212222222111111111
22222211122222222222211111111111
22222211112222222222222222222222
22222221112222222222222122222222
22222211112222222222222222222222
22222211111222222222222222222222
22222211111222222211111111111111
22222222111222222211111111111111
22222222111222222211111111111111
22222222111222222222222222222222
22222222222222222222222111111222
22222111111111122222222112111222
22222111111111122222222111111222
22222111111111122222222111111222
22222111111111122222222222111222

00000011100000111000000011100000
00000011100000111000000011100000
00111011101110111001110011100000
00111000001110000001110000000000
00111000001110000001110000000000
00000000000000000000000000000000
00000001111111111111000000000000
00000001101111111011000000000000
00000001111111111111000000000000
00000001111111111111000000000000
00000000000000000000011111111111
00000000000000000000011111111111
00000011100000010000000111111111
00000011100000000000011111111111
00000011110000000000000000000000
00000001110000000000000100000000
00000011110000000000000000000000
00000011111000000000000000000000
00000011111000000011111111111111
00000000111000000011111111111111
00000000111000000011111111111111
00000000111000000000000000000000
00000000000000000000000111111000
00000111111111100000000110111000
00000111111111100000000111111000
00000111111111100000000111111000
00000111111111100000000000111000
