IMG img/common/index.json
IMG img/box/index.json

NO box_w
SO box_w
WE box_w
EA box_w

1F box_f

D box_d

SK box_sk

PT S 6 0 box_p_mus box_p_mus_open maps/bonus/olafur/mus2.map W 8 4
PT S 15 3 box_p_box box_p_box_open maps/bonus/olafur/box.map W 23 1

SP sprite_box01 collision
15.5, 1.5
60.5, 1.5
26.5, 2.5
51.5, 2.5
5.5, 6.5

SP sprite_box02 collision
54.5, 2.5
57.5, 2.5
6.5, 3.5
32.5, 2.5

SP sprite_box03 collision
30.5, 1.5
7.5, 2.5
9.5, 2.5
22.5, 3.5
8.5, 4.5
9.5, 7.5

SP sprite_soul_idle collectible
49.5, 1.5
3.5, 2.5
18.5, 2.5
41.5, 2.5
2.5, 3.5

SP sprite_box04
45.5, 3.5
69.5, 3.5
3.5, 5.5
2.5, 7.5

M_BG audio/olafur/m_box.mp3

111111111111111111111111111111111111111111111111111111111111111111111
10000E000000000D00000000000000D000000000000000000D0000000000D00000001
100D000D0D00000000D0000000D00000D00000000D000000000D00D00D00000000001
10D000D000000000000000D000000000000D00000000000000000000000D000000001
10000000D001111111111111111111111111111111111111111111111111111111111
100D00000001
10000D000001111
10D000000D00001
111111111111111

111111111111111111111111111111111111111111111111111111111111111111111
111111111111111111111111111111111111111111111111111111111111111111111
111111111111111111111111111111111111111111111111111111111111111111111
111111111111111111111111111111111111111111111111111111111111111111111
111111111111111111111111111111111111111111111111111111111111111111111
111111111111
111111111111111
111111111111111
111111111111111
