JSON img/common/index.json
JSON img/dgn/index.json

1NO dgn_w
1SO dgn_w
1WE dgn_w
1EA dgn_w

2NO dgn_w2
2SO dgn_w2
2WE dgn_w2
2EA dgn_w2

3NO dgn_w3
3SO dgn_w3
3WE dgn_w3
3EA dgn_w3

4NO dgn_w4
4SO dgn_w4
4WE dgn_w4
4EA dgn_w4

F dgn_f
C dgn_c
F dgn_f_in

D dgn_d
G solid

S dgn_sk

P S 12 0 dgn_p maps/bonus/olafur/mus.map W 8 4

sprite_collec_soul_idle:
20.5, 11.5
18.5,  4.5
10.0,  4.5
10.0, 12.5
 3.5,  6.5
 3.5, 20.5
 3.5, 14.5
14.5, 20.5

sprite_pillar:
18.5, 10.5
18.5, 11.5
18.5, 12.5
 8.5,  7.0

sprite_barrel:
21.5,  1.5
15.5,  1.5
16.0,  1.8
16.2,  1.2
 3.5,  2.5
 9.5, 15.5
10.0, 15.1
10.5, 15.8

M audio/olafur/m_dgn.mp3

111111111111111111111111
100000000000000000000001
100000000000000000000001
100000000000000000000001
10000022D220000303030001
100000200020000000000001
100000200020000300030001
100000200020000000000001
10000022D220000303030001
100000000000000000000001
100000000000000000000001
100000000000000000000001
1000000000000000000000N1
100000000000000000000001
100000000000000000000001
100000000000000000000001
144444444000000000000001
140400004000000000000001
140000G04000000000000001
140400004000000000000001
140444444000000000000001
140000000000000000000001
144444444000000000000001
111111111111111111111111

000000000000000000000000
000000000000000000000000
000000000000000000000000
000000000000000000000000
000000111110000000000000
000000111110000000000000
000000111110000000000000
000000111110000000000000
000000111110000000000000
000000000000000000000000
000000000000000000000000
000000000000000000000000
000000000000000000000000
000000000000000000000000
000000000000000000000000
000000000000000000000000
011111111000000000000000
011111111000000000000000
011111011000000000000000
011111111000000000000000
011111111000000000000000
011111111000000000000000
011111111000000000000000
000000000000000000000000

000000000000000000000000
000000000000000000000000
000000000000000000000000
000000000000000000000000
000000111110000000000000
000000111110000000000000
000000111110000000000000
000000111110000000000000
000000111110000000000000
000000000000000000000000
000000000000000000000000
000000000000000000000000
000000000000000000000000
000000000000000000000000
000000000000000000000000
000000000000000000000000
011111111000000000000000
011111111000000000000000
011111011000000000000000
011111111000000000000000
011111111000000000000000
011111111000000000000000
011111111000000000000000
000000000000000000000000
