IMG img/common/index.json
IMG img/brain/index.json

M_BG audio/olafur/m_brain.mp3

SK brain_sk

NO brain_w
SO brain_w2
WE brain_w3
EA brain_w4

D brain_d brain_d_open

1F brain_f_in
2F brain_f
1C brain_c

PT EA 21 12 brain_p brain_p_open maps/olafur/brain.map NO 26 12
PT NO 26 12 brain_p brain_p_open maps/olafur/brain.map EA 21 12
PT NO 22 20 brain_p brain_p_open maps/olafur/mus2.map SO 4 0
PT WE 1 14 brain_p brain_p_open maps/olafur/brain.map EA 44 14
PT EA 44 14 brain_p brain_p_open maps/olafur/brain.map WE 1 14
PT EA 1 21 brain_p brain_p_open maps/olafur/brain.map WE 44 21
PT WE 44 21 brain_p brain_p_open maps/olafur/brain.map EA 1 21
PT SO 4 23 brain_p brain_p_open maps/olafur/brain.map NO 41 23
PT NO 41 23 brain_p brain_p_open maps/olafur/brain.map SO 4 23
PT EA 5 12 brain_p brain_p_open maps/olafur/brain.map WE 40 12
PT WE 40 12 brain_p brain_p_open maps/olafur/brain.map EA 5 12
PT NO 6 7 brain_p brain_p_open maps/olafur/brain.map SO 39 7
PT SO 39 7 brain_p brain_p_open maps/olafur/brain.map NO 6 7
PT SO 7 15 brain_p brain_p_open maps/olafur/brain.map NO 38 15
PT NO 38 15 brain_p brain_p_open maps/olafur/brain.map SO 7 15
PT SO 8 8 brain_p brain_p_open maps/olafur/brain.map NO 37 8
PT NO 37 8 brain_p brain_p_open maps/olafur/brain.map SO 8 8
PT EA 10 1 brain_p brain_p_open maps/olafur/brain.map WE 37 1
PT WE 37 1 brain_p brain_p_open maps/olafur/brain.map EA 10 1
PT EA 11 24 brain_p brain_p_open maps/olafur/brain.map WE 25 24
PT WE 25 24 brain_p brain_p_open maps/olafur/brain.map EA 11 24
PT NO 11 15 brain_p brain_p_open maps/olafur/brain.map SO 36 15
PT SO 36 15 brain_p brain_p_open maps/olafur/brain.map NO 11 15
PT SO 12 17 brain_p brain_p_open maps/olafur/brain.map NO 35 17
PT NO 35 17 brain_p brain_p_open maps/olafur/brain.map SO 12 17
PT NO 12 0 brain_p brain_p_open maps/olafur/brain.map SO 35 0
PT SO 35 0 brain_p brain_p_open maps/olafur/brain.map NO 12 0
PT WE 15 3 brain_p brain_p_open maps/olafur/brain.map EA 30 3
PT EA 30 3 brain_p brain_p_open maps/olafur/brain.map WE 15 3
PT NO 26 15 brain_p brain_p_open maps/olafur/brain.map SO 25 15
PT SO 25 15 brain_p brain_p_open maps/olafur/brain.map NO 26 15

SP 17.5 13.5 sprite_brain01 collision
SP 16.5 12.5 sprite_brain02 collision
SP 17.5 6.5 sprite_brain03 collision
SP 30.5 16.5 sprite_brain04 collision
SP 28.5 3.5 sprite_brain05 collision
SP 33.5 12.5 sprite_brain05 collision
SP 11.5 12.5 sprite_brain06 collision
SP 43.5 7.5 sprite_brain07 collision
SP 22.5 13.5 sprite_brain08
SP 26.5 9.5 sprite_brain10 collision
SP 20.5 2.5 sprite_brain11 collision

SP 24.5 12.5 sprite_brain09 collectible collision

         11111111111     11111111111
       11000000100001   10000110100001
      1100000010010001 1000100100000011
   1110100000100001001D1001000010000010111
  10100010000100001111011110000100001000101
 1001100000011110000010100000111100000011001
 1000011111100000000010100000000011111100001
100000000000111000000101000000111000000000001
111011110111000011111101111110000011011110111
100100001000000000000101000000000000100001001
101100010000000000000101000000000000010001101
100100001111111000011101110000111111100001001
1011000001100000111101S1011110000011000001101
101000100001001110000D0D000011100100001000101
100100100001000100011101100001000100001001001
110000011110000001111101101100000011110000011
100001100011100011100101001110001110001100001
 1000100111111111100110110011111101110010001
 110100000000000000111D111000000000000001011
 1001000100011111100110110011111100010001001
  11001001001000000001010000000010010010011
   100100101000000011   110000000101001001
    110001100000011       110000001100011
     111100000011           110000001111
        1111111               1111111

         11111111111     11111111111
       11111111111111   11111111111111
      1111111111111111 1111111111111111
   111111111111111111121111111111111111111
  11111111111111111111211111111111111111111
 1111111111111111111112111111111111111111111
 1111111111111111111112111111111111111111111
111111111111111111111121111111111111111111111
111111111111111111111121111111111111111111111
111111111111111111111121111111111111111111111
111111111111111111111121111111111111111111111
111111111111111111111121111111111111111111111
111111111111111111111121111111111111111111111
111111111111111111111121111111111111111111111
111111111111111111111121111111111111111111111
111111111111111111111121111111111111111111111
111111111111111111111121111111111111111111111
 1111111111111111111112111111111111111111111
 1111111111111111111112111111111111111111111
 1111111111111111111112111111111111111111111
  11111111111111111111211111111111111111111
   111111111111111111   111111111111111111
    111111111111111       111111111111111
     111111111111           111111111111
        1111111               1111111

         11111111111     11111111111
       11111111111111   11111111111111
      1111111111111111 1111111111111111
   111111111111111111101111111111111111111
  11111111111111111111011111111111111111111
 1111111111111111111110111111111111111111111
 1111111111111111111110111111111111111111111
111111111111111111111101111111111111111111111
111111111111111111111101111111111111111111111
111111111111111111111101111111111111111111111
111111111111111111111101111111111111111111111
111111111111111111111101111111111111111111111
111111111111111111111101111111111111111111111
111111111111111111111101111111111111111111111
111111111111111111111101111111111111111111111
111111111111111111111101111111111111111111111
111111111111111111111101111111111111111111111
 1111111111111111111110111111111111111111111
 1111111111111111111110111111111111111111111
 1111111111111111111110111111111111111111111
  11111111111111111111011111111111111111111
   111111111111111111   111111111111111111
    111111111111111       111111111111111
     111111111111           111111111111
        1111111               1111111
