map_walls:
111111111111111111111111
100000000000000000000001
100000000000000000000001
100000000000000000000001
100000225220000303030001
100000200020000000000001
100000200020000300030001
100000200020000000000001
100000225220000303030001
100000000000000000000001
100000000000000000000N01
100000000000000000000001
100000000000000000000001
100000000000000000000001
100000000000000000000001
100000000000000000000001
144444444000000000000001
140400004000000000000001
140000604000000000000001
140400004000000000000001
140444444000000000000001
140000000000000000000001
144444444000000000000001
111111111111111111111111

map_buildings:
000000000000000000000000
000000000000000000000000
000000000000000000000000
000000000000000000000000
000000111110000000000000
000000111110000000000000
000000111110000000000000
000000111110000000000000
000000111110000000000000
000000000000000000000000
000000000000000000000000
000000000000000000000000
000000000000000000000000
000000000000000000000000
000000000000000000000000
000000000000000000000000
011111111000000000000000
011111111000000000000000
011111111000000000000000
011111111000000000000000
011111111000000000000000
011111111000000000000000
011111111000000000000000
000000000000000000000000

