map_walls:
111111111111111111111111
100000000000000000000001
100000000000000000000001
100000000000000000000001
100000225220000303030001
100000200020000000000001
100000200020000300030001
100000200020000000000001
100000225220000303030001
100000000000000000000001
100000000000000000000001
100000000000000000000001
1000000000000000000000N1
100000000000000000000001
100000000000000000000001
100000000000000000000001
144444444000000000000001
140400004000000000000001
140000604000000000000001
140400004000000000000001
140444444000000000000001
140000000000000000000001
144444444000000000000001
111111111111111111111111

map_buildings:
000000000000000000000000
000000000000000000000000
000000000000000000000000
000000000000000000000000
000000111110000000000000
000000111110000000000000
000000111110000000000000
000000111110000000000000
000000111110000000000000
000000000000000000000000
000000000000000000000000
000000000000000000000000
000000000000000000000000
000000000000000000000000
000000000000000000000000
000000000000000000000000
011111111000000000000000
011111111000000000000000
011111111000000000000000
011111111000000000000000
011111111000000000000000
011111111000000000000000
011111111000000000000000
000000000000000000000000

sprite_chalice:
20.5, 11.5
18.5,  4.5
10.0,  4.5
10.0, 12.5
 3.5,  6.5
 3.5, 20.5
 3.5, 14.5
14.5, 20.5

sprite_pillar:
18.5, 10.5
18.5, 11.5
18.5, 12.5
 8.5,  7.0

sprite_barrel:
21.5,  1.5
15.5,  1.5
16.0,  1.8
16.2,  1.2
 3.5,  2.5
 9.5, 15.5
10.0, 15.1
10.5, 15.8

