map_walls:
1111111
1S10001
101000G
1010001
1000001
0000101
1000001
1111111

map_ceil_floor:
1111111
1111111
1111111
1111111
1111111
1111111
1111111
1111111
