map_walls://museum//CHOISIR LA MAP PRINCIPAL
  1111     1111
 100001   100001
100P000111000P001
10000000000000001
 111111000111111
 1000000N0000001
 111111000111111
10000000000000001
100P000111000P001
 100001   100001
  1111     1111

11P11
10001
P0N0P
10001
11P11

1111M1111
100000001
100000001
100000001
P000N000P
100000001
100000001
100000001
1111P1111

111111111
P0001000P
111D0D111
   1N1
111D0D111
P0001000P
111111111

map_ceil_floor:

map_walls://pool
111111111
100000001
100000001
100000001
1000S0001
100000001
100000001
100000001
100000001
1111P1111

map_ceil_floor:
0000000000
0111111110
0111111110
0111111110
0111111110
0111111110
0111111110
0111111110
0111111110
0000000000

map_walls://afg
11111122211111222111111122211111
10000020200000202000000020200001
1022202D2022202D200222002D200001
102S2000002020000002020000000001
102D2000002D20000002D20000000001
10000000000000000000000000000001
10000003333333333333000000000001
10000003000000000003000000000001
10000003000000000003000000000001
10000003300333333333000000000001
10000000000000000000033330333333
10000000000000000000030030030003
10000022200000000000000030030003
10000020D00000000000033333333033
10000022220000000000000000000001
100000020D0000000000000000000001
10000022220000000000000000000001
100000D0222000000000000000000001
1000002220D000000033333333333333
100000002220000000D0000000000003
10000000202000000033333333333333
100000002D2000000000000000000001
10000000000000000000000222222001
10000333D3222220000000020G002001
10000300000020200000000200202001
1000030003000020000000022220D001
11111333332222211111111111111111

map_ceil_floor:
00000011100000111000000011100000
00000011100000111000000011100000
00111011101110111001110011100000
00111000001110000001110000000000
00111000001110000001110000000000
00000000000000000000000000000000
00000001111111111111000000000000
00000001101111111011000000000000
00000001111111111111000000000000
00000001111111111111000000000000
00000000000000000000011111111111
00000000000000000000011111111111
00000011100000000000000111111111
00000011100000000000011111111111
00000011110000000000000000000000
00000001110000000000000000000000
00000011110000000000000000000000
00000011111000000000000000000000
00000011111000000011111111111111
00000000111000000011111111111111
00000000111000000011111111111111
00000000111000000000000000000000
00000000000000000000000111111000
00000111111111100000000110111000
00000111111111100000000111111000
00000111111111100000000111111000
00000111111111100000000000111000



map_walls://findthebox//à dessiner
111111111111111111111111111111111111111111111111111111111111111111111
10000E000000000D00000000000000D000000000000000000D0000000000D00000001
100D000D0D00000000D0000000D00000D00000000D000000000D00D00D00000000001
10D000D000000000000000D000000000000D00000000000000000000000D000000001
10000000D001111111111111111111111111111111111111111111111111111111111
100D00000001
10000D000001111
10D000000D00001
111111111111111

map_ceil_floor:
000000000000000000000000000000000000000000000000000000000000000000000
000000000000000100000000000000100000000000000000010000000000100000000
000100010100000000100000001000001000000001000000000100100100000000000
001000100000000000000010000000000001000000000000000000000001000000000
000000001000000000000000000000000000000000000000000000000000000000000
000100000000
000001000000000
001000000100000
000000000000000

map_walls://maketheroom//à réflèchir
11111111111111111
100000000000000001
1000000000000000001
10000000000000000001
100000000000000000001
 1000000000000000000011
  100000000000000000001
   1100000000000000000011
     10000000000000000001
     1100000000000000000011
       10000000000000000001
       11000000000000000001
         100000000000000001
         11111111111111111
map_ceil_floor:

map_walls://dungeon
111111111111P11111111111
100000000000000000000001
100000000000000000000001
100000000000000000000001
10000022D220000303030001
100000200020000000000001
100000200020000300030001
100000200020000000000001
10000022D220000303030001
100000000000000000000001
100000000000000000000001
100000000000000000000001
1000000000000000000000N1
100000000000000000000001
100000000000000000000001
100000000000000000000001
144444444000000000000001
140400004000000000000001
140000G04000000000000001
140400004000000000000001
140444444000000000000001
140000000000000000000001
144444444000000000000001
111111111111111111111111
map_ceil_floor:
000000000000000000000000
000000000000000000000000
000000000000000000000000
000000000000000000000000
000000111110000000000000
000000111110000000000000
000000111110000000000000
000000111110000000000000
000000111110000000000000
000000000000000000000000
000000000000000000000000
000000000000000000000000
000000000000000000000000
000000000000000000000000
000000000000000000000000
000000000000000000000000
011111111000000000000000
011111111000000000000000
011111111000000000000000
011111111000000000000000
011111111000000000000000
011111111000000000000000
011111111000000000000000
000000000000000000000000

map_walls://add GDP please //brain room
         11111111111     11111111111
       11000000100001   10000110100001
      1100000010010001 1000100100000011
   1110100000100001001D1001000010000010111
  10100010000100001111011110000100001000101
 1001100000011110000010100000111100000011001
 1000011111100000000010100000000011111100001
100000000000111000000101000000111000000000001
111011110111000011111101111110000111011110111
100100001000000000000101000000000000100001001
101100010000000000000101000000000000010001101
100100001111111000011101110000111111100001001
101100000110000011110101011110000011000001101
101000100001001110000101000011100100001000101
100100100001000100011101110001000100001001001
110000011110000001111101111100000011110000011
100001100011100011100101001110001110001100001
 1000100111111111100110110011111111110010001
 11010W0000000000001110111000000000000001011
 100100010001111110111D111011111100010001001
  11001001001000000001 10000000010010010011
   100100101000000011   110000000101001001
    110001100000011       110000001100011
     111100000011           110000001111
        1111111               1111111

map_ceil_floor:
         11111111111     11111111111
       11111111111111   11111111111111
      111111111111111101111111111111111
   111111111111111111101111111111111111111
  11111111111111111111011111111111111111111
 1111111111111111111110111111111111111111111
 1111111111111111111110111111111111111111111
111111111111111111111101111111111111111111111
111111111111111111111101111111111111111111111
111111111111111111111101111111111111111111111
111111111111111111111101111111111111111111111
111111111111111111111101111111111111111111111
111111111111111111111101111111111111111111111
111111111111111111111101111111111111111111111
111111111111111111111101111111111111111111111
111111111111111111111101111111111111111111111
111111111111111111111101111111111111111111111
 1111111111111111111110111111111111111111111
 1111111111111111111110111111111111111111111
 1111111111111111111110111111111111111111111
  11111111111111111111 11111111111111111111
   111111111111111111   111111111111111111
    111111111111111       111111111111111
     111111111111           111111111111
        1111111               1111111

portal_1: /address to other map

portal_2: /address to other map

portal_3: /address to other map

sprite_obj1:
x, y

sprite_obj2:
x, y

spite_obj3:
x, y
